1111111
1P000C1
1011101
1C00001
100011E
1111111
