1111111
1E001C1
10000C1
111C001
1P00011
100C001
1C01111
1111111
